%%%%%%%%%%%%%%%%%%%%%%
%                    %
% %  % % % % % % % % %
%G%                 S%
% %  % % % % % % % % %
%                    %
%%%%%%%%%%%%%%%%%%%%%%
