%%%%%%%%%%%%%%%%%%%%%%
%   %                %
% % %%%%%%%%%%%%     % 
% % %                %
% % %%%%%%%%%%%%%    %
% % %                %
% % %%%%%%%%%%%%%%%  %
% % %                %
% % %%%%%%%%%%%%%%%% %
%G%                 S%
%%%%%%%%%%%%%%%%%%%% %
%                    %
%%%%%%%%%%%%%%%%%%%  %
%                    %
%%%%%%%%%%%%%%%%%    %
%                    %
%%%%%%%%%%%%%%%%%%%%%%